fol1	TCCACGATGAGGTAACCCCA	TGG	sense
fol2	TGGGGTTACCTCATCGTGGA	AGG	anti
fol3	GCCATGGGGTTACCTCATCG	TGG	anti
fol4	TAACCCCATGGCACGACCGC	TGG	sense
fol5	TCGCCAGCGGTCGTGCCATG	GGG	anti
fol6	ATCGCCAGCGGTCGTGCCAT	GGG	anti
fol7	CATCGCCAGCGGTCGTGCCA	TGG	anti
fol8	AGGGCGGCGATCATCGCCAG	CGG	anti
fol9	CGCGCGGTTCTCGCCAAGGG	CGG	anti
fol10	GATCGCGCGGTTCTCGCCAA	GGG	anti
fol11	CGATCGCGCGGTTCTCGCCA	AGG	anti
fol12	GGTTGTCGATGCCGATCGCG	CGG	anti
fol13	CCGGCAGGCGCCAGGGCAGG	CGG	anti
fol14	CGGCCGGCAGGCGCCAGGGC	AGG	anti
fol15	AGGTCGGCCGGCAGGCGCCA	GGG	anti
fol16	GAGGTCGGCCGGCAGGCGCC	AGG	anti
fol17	AATGCTTGAGGTCGGCCGGC	AGG	anti
fol18	TTGAAATGCTTGAGGTCGGC	CGG	anti
fol19	CGCCTTGAAATGCTTGAGGT	CGG	anti
fol20	TCATCGCCTTGAAATGCTTG	AGG	anti
fol21	CATGATCACCGGCTTGCCGA	GGG	anti
fol22	CCATGATCACCGGCTTGCCG	AGG	anti
fol23	GTCTTGCGCCCCATGATCAC	CGG	anti
fol24	CGGCCGACCCAGCGAGTCCC	AGG	anti
fol25	AGGTTGAGCCGGCCCGGCAG	CGG	anti
fol26	ACCACCAGGTTGAGCCGGCC	CGG	anti
fol27	GGCTGACCACCAGGTTGAGC	CGG	anti
fol28	CGGCCTGGCGGCTGACCACC	AGG	anti
fol29	CCAGTGCCAGGCCGGCCTGG	CGG	anti
fol30	CCTCCAGTGCCAGGCCGGCC	TGG	anti
fol31	CGCACCCTCCAGTGCCAGGC	CGG	anti
fol32	CTTCCGCACCCTCCAGTGCC	AGG	anti
fol33	CGCCAGCGCGGCGTCCAGGC	TGG	anti
fol34	CGCGCGCCAGCGCGGCGTCC	AGG	anti
fol35	CGCCTCGGCGCGCGCCAGCG	CGG	anti
fol36	CTCCGCCTGCGCCCACGCCT	CGG	anti
fol37	GCCGATCAGCATCAGTTCGT	CGG	anti
fol38	CAAGGCCTCGGCATAGAGCT	GGG	anti
fol39	GCAAGGCCTCGGCATAGAGC	TGG	anti
fol40	CGCGGCGCGCGGCAAGGCCT	CGG	anti
fol41	GAGGCGCGCGGCGCGCGGCA	AGG	anti
fol42	AGGTAGAGGCGCGCGGCGCG	CGG	anti
fol43	CCGGGTCAGGTAGAGGCGCG	CGG	anti
fol44	GGCCCACCCGGGTCAGGTAG	AGG	anti
fol45	GCGCCAGGCCCACCCGGGTC	AGG	anti
fol46	TTCCGGCGCCAGGCCCACCC	GGG	anti
fol47	CTTCCGGCGCCAGGCCCACC	CGG	anti
fol48	AGGCGTCGCCTTCCGGCGCC	AGG	anti
fol49	GGGAAAAAGGCGTCGCCTTC	CGG	anti
fol50	GCCATCGATCTCGGGGAAAA	AGG	anti
fol51	AGGCCGCGCCATCGATCTCG	GGG	anti
fol52	CAGGCCGCGCCATCGATCTC	GGG	anti
fol53	CCAGGCCGCGCCATCGATCT	CGG	anti
fol54	GATGCTCGACGCCAGGCGCC	AGG	anti
fol55	CGTGTTCGATGCTCGACGCC	AGG	anti
fol56	GGCAGGCGCATCGTCAGCCG	CGG	anti
fol57	CATACCTCGAAGGCGTAGGC	AGG	anti
fol58	CTCCCATACCTCGAAGGCGT	AGG	anti
fol59	GCGGCGCTCCCATACCTCGA	AGG	anti
